11111111
1C0100C1
10000001
1C001101
100P1E01
11111111