1111111111111
1E0CCCCCCCCC1
11111C111C1C1
1CGC111C11101
1CPCCCCCCC001
1111111111111
