1111111111111
1ECCCCCCCCCC1
11111C111C1C1
1C1C111C11101
1CPCCCCCCC001
1111111111111
