1111111111111
1E0000C0000C1
1C111C111C1C1
1C1C111C111C1
1P000C000C001
1111111111111
