1111111111111
1ECCCCCCCCCC1
11111C111C1C1
1C1C111C111C1
1CPCCCCCCCCC1
1111111111111
